001111111100
011111111330
111111111331
141111111141
141111111141
001111111100
111111111111
111111111111
141111111141
141111111141
122111111111
022111111110
