0000000000000000000
0001111111111111000
0011111111111113300
0111111111111116310
0111441111111111110
0111441111111111110
0111111111111111110
0111111114111111110
0111111114111111110
0111111444441111110
0111111114111111110
0111111114111111110
0111111111111111110
0111111111111441110
0111111111111441110
0125111111111111110
0022111111111111100
0001111111111111000
0000000000000000000
