000000000000000
000111111111000
001111111113300
011111111113310
011111111111110
011111111111110
011111141111110
011111444111110
011111141111110
011111111111110
011111111111110
012211111111110
002211111111100
000111111111000
000000000000000
