001111100
011111330
111111331
111111111
111111111
111111111
122111111
022111110
001111100
