0000000000000000000
0001111111111111000
0011114111111111100
0111111411111116110
0111111141111111110
0111111111411111110
0111111111111111110
0111111144411111110
0111111141411111140
0111111144411111140
0111111111111111140
0111111111111111110
0111114111111111110
0114444111111111110
0111114111111111110
0115111111111111110
0011111111111111100
0001111111111111000
0000000000000000000
